1,1,1,1,1,1,1,1,1,1,1,1,1,1,1,1,1,1,1,1
1,4,0,0,0,4,0,0,0,4,1,0,0,0,4,4,4,4,5,1
1,0,0,4,0,0,0,4,0,4,1,0,4,0,4,4,4,4,0,1
1,0,1,1,1,1,0,4,0,0,1,0,4,0,4,4,4,4,0,1
1,0,0,0,4,2,1,1,1,0,1,0,4,0,0,0,0,4,0,1
1,0,0,0,4,2,1,0,4,2,2,0,4,4,4,4,0,4,0,1
1,0,1,1,1,1,1,0,4,2,2,4,0,0,0,0,0,4,0,1
1,0,1,0,0,0,0,0,0,1,4,4,0,4,4,4,4,4,0,1
1,0,1,0,4,4,0,4,0,1,2,4,0,4,0,0,0,4,0,1
1,0,1,0,0,0,4,0,0,1,2,4,0,4,0,4,0,4,0,1
1,3,0,0,4,0,0,0,0,1,2,4,0,0,0,4,0,0,0,1
1,1,1,1,1,1,1,1,1,1,1,1,1,1,1,1,1,1,1,1