1,1,1,1,1,1,1,1,1,1,1,1,1,1,1,1,1,1,1,1
1,0,0,0,0,0,0,4,0,0,0,4,0,0,0,0,4,0,2,1
1,0,1,1,1,1,0,0,0,4,0,0,0,1,0,0,0,0,0,1
1,0,0,0,0,1,0,0,0,4,0,0,0,1,1,1,1,0,4,1
1,0,4,0,0,1,0,4,0,0,0,4,0,0,0,0,0,0,4,1
1,1,1,0,0,1,1,1,1,1,1,1,1,1,1,1,1,1,1,1
1,0,0,0,0,1,4,1,2,1,1,1,4,1,1,1,2,1,4,1
1,0,4,4,4,1,4,2,1,2,1,4,2,4,1,2,1,2,4,1
1,3,4,2,2,1,4,3,2,3,1,1,4,1,1,3,2,3,4,1
1,1,1,1,1,1,1,1,1,1,1,1,1,1,1,1,1,1,1,1